wwwwwwwwww
w      c w
w   Bb   w
w     b  w
w        w
w     g  w
w        w
w  gbg   w
w        w
wwwwwwwwww