wwwwwwwwww
w g      w
w    b   w
w     b  w
w        w
w     g  w
w b      w
w        w
wg    c  w
wwwwwwwwww